e---e-----e--------e---------e--------e---e--------e-------e-------e---------e-------------e----------e----------e
------------------------------------------------------------------------------------------------------------------
------------------------------------------------------------------------------------------------------------------
------------------------------------------------------------------------------------------------------------------
------------------------------------------------------------------------------------------------------------------
------------------------------------------------------------------------------------------------------------------
------------------------------------------------------------------------------------------------------------------
------------------------------------------------------------------------------------------------------------------
-------------------------------T----------------------------------------------------------------------------------
------------------------------------------------------------------------------------------------------------------
------------------------------------------------------------------------------------------------------------------
------------------------------------------------------------------------------------------------------------------
--------------------XXXX------------?-----------------------------------------------------------------------------
--------------XXX---XXXX-----X------------XXX----------------------XXXXXXXXXXX---------------------?-------E------
-------------XXXX---XXXX-----X------------XXXX--------------------XXXXXXXXXXXXX------------XXX--------------------
-p----------XXXXX---XXXX----XX---XXXXX----XXXXX-------s----------XXXXXXXXXXXXXXXX-----XX---XXX---X----------------
XXXXXXXXXXXXXXXXX---XXXX--XXXX------------XXXXXXXXXXXXXXXXXXXXXXXXXXXXXXXXXXXXXXX-----XX---XXX---XXXXXXXXXXXXXXXXX
XXXXXXXXXXXXXXXXXLLLXXXXLLXXXXLLLLLLLLLLLLXXXXXXXXXXXXXXXXXXXXXXXXXXXXXXXXXXXXXXXLLLLLXXLLLXXXLLLXXXXXXXXXXXXXXXXX
-------------------------------F---------F-----------------------------------------------------------------------