e---e-----e--------e---------e--------e---e--------e-------e-------e---------e-------------e----------e----------e
------------------------------------------------------------------------------------------------------------------
--------------------------------------------------------------------------------XXXXXXXXXXXXXXXXXXXXXXXXXXXXXXXXXX
--------------------------------------------------------------------------------X-------------------XXXXXXXXXXXXXX
--------------------------------------------------------------------------------X-------------------XXXXXXXXXXXXXX
--------------------------------------------------------------------------------X-------------------XXXXXXXXXXXXXX
XXXXXXXXXXXXXXXXXXXXXXXXXXXXXXXXXXXXXXXXXXXXXXXX--------------XXXXXXXXXXXXXXXXXXX-------------------XXXXXXXXXXXXXX
XXXXXXXXXXXXX----------------------------------X--------------X-------------------------------------XXXXXXXXXXXXXX
XXXXXXXXXXXXX------------------T---------------X--------------X--------------------------------------XXXXXXXXXXXXX
XXXXXXXXXXXXX----------------------------------X--------------X----------------------------------------XXXXXXXXXXX
XXXXXXXXXXXX-----------------------------------X--------------X------------------------------------------XXXXXXXXX
XXXXXXXXXXX-------------------------------------X--------------X---------------------------------------------XXXXX
XXXXXXXXXX----------XXXX------------?-----------XXXXXXXXXXXXXXX---s---------------------------------------------XX
--------------XXX---XXXX-----X------------XXX----------------------XXXXXXXXXXX---------------------?-------E----XX
-------------XXXX---XXXX-----X------------XXXX--------------------XXXXXXXXXXXXX------------XXX------------------XX
-p----------XXXXX---XXXX----XX---XXXXX----XXXXX-------s----------XXXXXXXXXXXXXXXX-----XX---XXX---X--------------XX
XXXXXXXXXXXXXXXXX---XXXX--XXXX------------XXXXXXXXXXXXXXXXXXXXXXXXXXXXXXXXXXXXXXX-----XX---XXX---XXXXXXXXXXXXXXXXX
XXXXXXXXXXXXXXXXXLLLXXXXLLXXXXLLLLLLLLLLLLXXXXXXXXXXXXXXXXXXXXXXXXXXXXXXXXXXXXXXXLLLLLXXLLLXXXLLLXXXXXXXXXXXXXXXXX
-------------------------------F---------F-----------------------------------------------------------------------