--------------------------------------------------------------------------------------------------------------------------------------------------------e--------------e--------------e-------e--------
------------C------------------------------------------------------------------------------------------------------------------------------------------------------------------------------------------
------C------------------------------------------------------------------------------------------------------------------------------------------------------------------------------------------------
--------------C----------------------------------------------------------------------------------------------------------------------------------------------------------------------------------------
-------------------------------------------------------------------------------------------------------------------------------------------------------------------------------------------------------
-------------------------------------------------------------------------------------------------------------------------------------------------------------------------------------------------------
-------------------------------------------------------------------------------------------------------------------------------------------------------------------------------------------------------
------------------------------------------------------------------------------------------------------------------------------------------------------------------------------------------------------
---------------------------------------------------------------------------------------------------7---------OOO------------5--------------------------------------------------------------------------
-------------------------------------------------------------------------------------------------------------------------------------------------------------------------------------------------------
--------------------------------------------------------------------------------------------------------O----7-----------------------------------------------------------------------------------------
--------------6-------------------------------------------------------------------------------------------------------7--------------------------------------------------------------------------------
--------------------------------bbbb------------------------OOO-----OOO-----------------------------O---7------k---------------------------------------------------------------------------------------
---------------------------bbb--bb-b----DDDD---D-----------------D-------D--------------------------------------8------------------------------------------------------------------E-------------------
---------------------------bbbbb---b-----------D--------D--------D-------D------------------------8------------------------o---------------------------------------------------------------------------
-----------9---------------b?--bbbbb-----------D--------D--------D-------D-----------------------------------------------------------------------------------------------------------------------------
-p--ffff--------g-------ff-bbb---bbb-----------D-----f--D----fff-D-------D---------------------------------g-------------------------------------------------------------------------------------------
##############################################################################-##############-#########################################################################################################
-------------------------------------------------------------------------------------------------------------------------------------------------------------------------------------------------------