--------------------------------------------------------------------------------------------------------------------------------------------------------e--------------e--------------e-------e--------
------------C------------------------------------------------------------------------------------------------------------------------------------------------------------------------------------------
------C------------------------------------------------------------------------------------------------------------------------------------------------------------------------------------------------
--------------C-----------------------------------------------------------O----------------------------------------------------------------------------------------------------------------------------
-------------------------------------------------------------------------------------------------------------------------------------------------------------------------------------------------------
------------------------------------------------------------------------O------------------------------------------------------------------------------------------------------------------------------
-------------------------------------------------------------------------------------------------------------------------------------------------------------------------------------------------------
----------------------------------------------------------------------O--------------------------------------------------------------------------------------------------------------------------------
--------------------------------------------------------------------------------------------------------------------------------------------5----------------------------------------------------------
---------------S----------------------------------------------------O----------------------------------------------------------------------------------------------------------------------------------
--------------??---------------W------------------------------------------g----------------------------------------------------------------------------------------------------------------------------
------------------------------------------------------------------O------bbb------4--------------------------------------------------------------------------------------------------------------------
-----------------B------------R--------------?------H----------------------------------------DD--------------------------------------------------------------------------------------------------------
-H---------??-------------------------------------------------------------------3----------?------------------------------------------------------------------------------------E----------------------
---------------o----------G-------------------------------------------------------------------------D----D---------------------bbbb-------o------DD----------------------------------------------------
-----------------------|----------2--------?--------?------------ff------------2-------------------DD----DD------|----|-------bbbbb---b----------|-----|----------------------------------------------
-p--------fff---g---w--P----------------###########################---------k---------------------DDD----DDD-fff-------------bbbbbbb--bb---------------------------------------------------------------
################################################################################################################################################-######################################################
--------------------------------------------------------------------------------------------------------------------------------------------------------------------------------------------------------