----------------------------------------------------------------------------------------------------------------------------------------------------------e--------------------------------------------
------------C------------------------------------------------------------------------------------------------------------------------------------------------------------------------------------------
------C------------------------------------------------------------------------------------------------------------------------------------------------------------------------------------------------
--------------C-----------------------------------------------------------O----------------------------------------------------------------------------------------------------------------------------
----------------------------------------------------------T--------------------------------------------------------------------------------------------------------------------------------------------
------------------------------------------------------------------------O------------------------------------------------------------------------------------------------------------------------------
-------------------------------------------------------------------------------------------------------------------------------------------------------------------------------------------------------
----------------------------------------------------------------------O--------------------------------------------------------------------------------------------------------------------------------
--------------------------------------------------------------------------------------------------------------------------------------------5----------------------------------------------------------
--------------------------------------------------------------------O----------------------------------------------------------------------------------------------------------------------------------
--------------??---------------W-----------------------------------------------------------------------------------------------------------------------------------------------------------------------
------------------------------------------------------------------O---------------4--------------------------------------------------------------------------------------------------------------------
-----------------B------------R--------------?------H----------------------------------------DD--------------------------------------------------------------------------------------------------------
-H---------??-------------------------------------------------------------------3----------?------------------------------------------------------------------------------------E----------------------
---------------o----------G-------------------------------------------------------------------------D----D---------------------bbbb-------o------DD----------------------------------------------------
-----------------------|----------2--------?------s-?------------ff------------2-------------------DD----DD------|----|-------bbbbb---b----------|-----|----------------------------------------------
-p--S-----fff--------w------------------###########################-------------------------------DDD----DDD-fff-------------bbbbbbb--bb---------------------------------------------------------------
######LLL##########################################################LLLL######################LL######LLLL#######################################-######################################################
-------F------------------------------------------------------------------------------------------------------------------------------------------------------------------------------------------------