eXXXeXXXXXeXXXXXXXXeXXXXXXXXXeXXXXXXXXeXXXeXXXXXXXXeXXXXXXXeXXXXXXXeXXXXXXXXXeXXXXXXXXXXXXXeXXXXXXXXXXeXXXXXXXXXXe
XXXXXXXXXXXXXXXXXXXXXXXXXXXXXXXXXXXXXXXXXXXXXXXXXXXXXXXXXXXXXXXXXXXXXXXXXXXXXXXXXXXXXXXXXXXXXXXXXXXXXXXXXXXXXXXXXX
XXXXXXXXXXXXXXXXXXXXXXXXXXXXXXXXXXXXXXXXXXXXXXXXXXXXXXXXXXXXXXXXXXXXXXXXXXXXXXXXXXXXXXXXXXXXXXXXXXXXXXXXXXXXXXXXXX
XXXXXXXXXXXXXXXXXXXXXXXXXXXXXXXXXXXXXXXXXXXXXXXXXXXXXXXXXXXXXXXXXXXXXXXXXXXXXXXXX-------------------XXXXXXXXXXXXXX
XXXXXXXXXXXXXXXXXXXXXXXXXXXXXXXXXXXXXXXXXXXXXXXXXXXXXXXXXXXXXXXXXXXXXXXXXXXXXXXXX-------------------XXXXXXXXXXXXXX
XXXXXXXXXXXXXXXXXXXXXXXXXXXXXXXXXXXXXXXXXXXXXXXXXXXXXXXXXXXXXXXXXXXXXXXXXXXXXXXXX-------------------XXXXXXXXXXXXXX
XXXXXXXXXXXXXXXXXXXXXXXXXXXXXXXXXXXXXXXXXXXXXXXXXXXXXXXXXXXXXXXXXXXXXXXXXXXXXXXXX-------------------XXXXXXXXXXXXXX
XXXXXXXXXXXXX----------------------------------XXXXXXXXXXXXXXXX-------------------------------------XXXXXXXXXXXXXX
XXXXXXXXXXXXX------------------T---------------XXXXXXXXXXXXXXXX--------------------------------------XXXXXXXXXXXXX
XXXXXXXXXXXXX----------------------------------XXXXXXXXXXXXXXXX----------------------------------------XXXXXXXXXXX
XXXXXXXXXXXX-----------------------------------XXXXXXXXXXXXXXXX------------------------------------------XXXXXXXXX
XXXXXXXXXXX-------------------------------------XXXXXXXXXXXXXXXX---------------------------------------------XXXXXX
XXXXXXXXXX----------XXXX------------?-----------XXXXXXXXXXXXXXX---s---------------------------------------------XX
--------------XXX---XXXX-----X------------XXX----------------------XXXXXXXXXXX---------------------?-------E----XX
-------------XXXX---XXXX-----X------------XXXX--------------------XXXXXXXXXXXXX------------XXX------------------XX
-p----------XXXXX---XXXX----XX---XXXXX----XXXXX-------s----------XXXXXXXXXXXXXXXX-----XX---XXX---X--------------XX
XXXXXXXXXXXXXXXXX---XXXX--XXXX------------XXXXXXXXXXXXXXXXXXXXXXXXXXXXXXXXXXXXXXX-----XX---XXX---XXXXXXXXXXXXXXXXX
XXXXXXXXXXXXXXXXXLLLXXXXLLXXXXLLLLLLLLLLLLXXXXXXXXXXXXXXXXXXXXXXXXXXXXXXXXXXXXXXXLLLLLXXLLLXXXLLLXXXXXXXXXXXXXXXXX
-------------------------------F---------F-----------------------------------------------------------------------